모델링의 특징
- 추상화 : 일정한 형식에 맞게 표현
- 단순화 : 서로가 약속한 규약을 준수하는 표기법이나 언어로 표현
- 명확화 : 명확하게 기술, 모델을 보는 여러 사람이 이해하기 쉽게 애매한거 삭제해서 표현

모델링의 정의
- 복잡한 현실 세계를 추상화, 단순화, 명확화하기 위해 일정한 표기법으로 모델을 표현하는 기법

모델링의 3가지 관점
- 데이터 : 비즈니스와 관련된 데이터는 무엇인지 또는 데이터 간의 관계는 무엇인지 What에 대한 관점
- 프로세스 : 해달 비즈니스로 인해 일어나는 일은 어떠한 일인지, How에 대한 관점
- 상관 : 데이터 관점과 프로세스 관점 간 서로 어떠한 영향을 받는지에 대한 관점

데이터 모델링의 정의
- 현실 세계의 비즈니스를 IT 시스템으로 구현하기 위해 데이터 관점으로 업무를 분석하는 기법
- 약속된 표기법으로 표현하는 과정
- IT 시스템의 근간이 되는 데이터베이스를 구축하기 위한 분석 및 설계의 과정

데이터 모델의 기능
- 가시화 : IT 시스템의 모습을 가시화하는 기능
- 명세화 : IT 시스템의 구조와 발생하는 동작을 명세화하는 기능
- 구조화된 틀 제공 : IT 시스템을 구현하기 위해 필요한 구조화된 틀
- 문서화 : IT 시스템 구축 시 산출물(기록물)로 사용되는 문서
- 다양한 관점 제공 : 다른 영역의 세부사항을 숨김으로써 다양한 영역에 집중할 수 있는 관점
- 상세 수준의 표현 방법 제공 : 원하는 목표에 따라 구체화된 상세 수준의 표현 방법

데이터 모델이 중요한 이유 
- 파급효과 : 데이터 설꼐 과정에서 비효율적인 데이터 설계 및 업무 요건을 충족하지 못하게 데이터 설계를 한다면 개발/테스트/오픈/운영의
전 과정에 걸쳐서 엄청난 비용이 발생할 수 있다.
- 복잡한 정보 요구사항의 간결한 표현 : 좋은 데이터 모델 설계를 통해 IT 시스템에서 구현해야 할 정보 요구사항을 명확하고, 간결하게 표현
- 데이터 품질 : 데이터 모델의 잘못된 설계로 인해 데이터 중복, 비유연성, 비일관성이 발생할 수 있다 / 데이터 중복, 비유연성, 비일관성으로 인해 데이터 품질이 저하될 수 있다.

데이터 모델링의 3단계 진행
  현실 세계 -- 개념 데이터 모델링 (추상적) ---> 개념적 구조 --- 논리 데이터 모델링 ---> 
  논리적 구조 --- 물리 데이터 모델링 (구체적) ---> 물리 구조 (데이터베이스)

데이터 모델링의 3단계
- 개념적 데이터 모델링 : IT 시스템에서 구현하고자 하는 대상에 대해 포괄적 수준의 데이터 모델링을 진행한다. / 전사적 모델링시 많이 사용
- 논리적 데이터 모델링 : 비즈니스를 만족하기 위한 기본키, 속성, 관계, 외래키등을 정확하게 표현하는 단계이다.
- 물리적 데이터 모델링 : 논리 데이터 모델을 기반으로 실제 물리 DB 구축을 위해 성능, 저장공간 등의 물리적인 특성을 고려하여 설계하는 단계
